XXXXXXXXXXXEXXXXXXXX
XXXXXXXX     XXXX XX
XXUXUXXX XXXXXXXX XX
XX       X XXXXXX XX
XX UUXUXXX XXXXXX XX
XX XXX XXX      X XX
XX     XXX XXXX   XX
XXXXXX     XX UXX  X
XXXXXXXXUXXXX XXXX X
XX       XXXX XXX  X
XXXXX XU      XXX XX
XXU   XX XXXX XXX  X
XXX XXXX UUXX XXXX X
X   XXXX  XXX    X X
X XX   XXXXXXXXX X X
X XU U  XXXXXXXX X X
X  X XX XXXXX XX   X
XX   XX       XXX XX
XXXXXXXXXX XUUXXXXXX
XXXXXXXXXXAXXXXXXXXX