XXXXXXXXXUXEXXXXXXXX
XXXXXXXX     XXXX XX
XXXXXXXX XXXXXXXX XX
XX       X XXXXXX XX
XX XXXXXXX XXXUXX XX
XX XXU XXX      X XX
XX     XXX XXXX   XX
XXXXXX     XX XXX  X
XXUXXXXXXXXXX XXXX X
XX       XXXX XXX  X
XXXXX XX      XXX XX
XXX   XX XXXX XXX  X
XXX XXXX XXXX XXXX X
X   XXXX  XXX    X X
X XX   XXXXXXXXX X X
X XX X  XXXXXUXX X X
X  X XX XXXXX XX   X
XX   XX       XXX XX
XXXXXXXXXX XXXXXXXXX
XXXXXXXXXXAXXXXXXXXX