XXXXEXXXXUUXXXXXXXXX
XX U  X   X        X
X  X  X   X   X XXXX
X       X   X      X
XXXXXXXXXXX   UXX  X
X     U      X X   X
X  XXXXXXXXX U UX XX
X  X         X  X  X
X  XXXX  XXXX  UUXXX
X     X    X  X    X
XUX  XXX  XXXX  U  X
X      X  X     X  X
X  U  X  X  XXX  UXX
X  X  X  X    X    X
XXXX  UXX  XXX  X  X
X      X  X     X  X
XXX  U  X  X X  X  X
X  X  X      X  X  X
X  XXXX  XXXXX  XXXX
XXXXXXXXXXXXXXAXXXXX