XEXXXXXXUUXUXXXXXXXX
X      X  X        X
X  XXXX  X  X   XXXX
X  X  X    X  X  X X
X  X  X  X  UUX  XXX
X      U     X  X  X
X  X  X  XX  X  X  X
X  X  U  X      X  X
XUXXX  XXXX  XUXX  X
X         X  X     X
X  UXXX XXX  X   XXX
X  X     X     X   X
XUUX  X  XXXXXXXX  X
X     X            X
XXXX XUXXXXXXX  XXUX
X           U      X
XXXXX  XXXXX XX X  X
X  X     X XX      X
X  XXXXX X XXXXXX  X
XXXXXXXXXXXXXXXXXAXX