XEXXXXXXXXXXXXXXXXXX
X      X  U        X
X  XUXX  X  X   XXUX
X  X  X    X  X  X X
X  X  X  X  XXX  XXX
X      X     X  X  X
X  X  U  XX  X  X  X
X  X  X  X      X  X
XXXXX  XUXX  XXXX  X
X         X  X     X
X  XXXX XXU  X   XXX
X  X     X     U   X
XXXX  X  UUXXXXXX  X
X     X            X
XXXX XXXXXXXUX  XXXX
X           X      X
XXXXX  XXXXU UU X  X
X  X     X XX      X
X  XXXXX X XXUXUX  X
XXXXXXXXXXXXXXXXXAXX